{
    "tiles": [
      ["w", "w", "w", "w", "w", "w", "w", "w", "w", "w", "w", "w", "w", "w", "w", "w", "w", "w", "w", "w", "w", "w"],
      ["w", "p", "w", "w", "w", ".", "w", "c", ".", "h", "c", "w", "w", "w", "w", "w", "w", "w", ".", ".", ".", "w"],
      ["w", ".", "w", ".", "w", ".", "w", "w", "w", ".", "w", ".", "w", "w", "w", "w", "w", "w", ".", ".", ".", "w"],
      ["w", "c", "w", "ou", "w", "c", "w", ".", ".", ".", "w", ".", ".", ".", ".", ".", ".", ".", ".", ".", "od", "w"],
      ["w", ".", "m", ".", "m", ".", "w", ".", ".", ".", "w", ".", ".", ".", ".", ".", ".", ".", ".", "w", "c", "w"],
      ["w", ".", ".", ".", ".", ".", "w", ".", ".", "w", ".", ".", ".", ".", ".", ".", ".", ".", ".", ".", "h", "w"],
      ["w", ".", ".", ".", ".", ".", ".", "w", ".", "w", ".", "w", "w", "w", ".", ".", ".", ".", ".", ".", ".", "w"],
      ["w", ".", "w", ".", ".", ".", ".", "w", ".", "w", ".", "w", "c", "or", ".", ".", ".", ".", ".", ".", ".", "w"],
      ["w", ".", ".", "w", ".", "m", ".", "w", ".", "w", ".", "w", "ou", "w", ".", ".", ".", ".", ".", ".", ".", "w"],
      ["w", ".", ".", ".", "w", "c", "m", "w", ".", "w", ".", "w", ".", "w", ".", ".", ".", ".", ".", ".", ".", "w"],
      ["w", ".", "m", ".", ".", "m", ".", "m", ".", ".", ".", "w", ".", "w", ".", ".", ".", ".", ".", ".", ".", "w"],
      ["w", ".", "w", ".", "m", ".", "m", ".", ".", ".", ".", "w", "h", ".", ".", ".", ".", ".", ".", "h", ".", "w"],
      ["w", ".", ".", "w", ".", "m", ".", "m", ".", ".", ".", "w", "w", "w", ".", ".", ".", ".", "h", "x", "h", "w"],
      ["w", ".", ".", ".", "w", ".", "m", ".", ".", ".", ".", ".", ".", ".", ".", ".", ".", ".", ".", "h", ".", "w"],
      ["w", ".", ".", ".", ".", "m", ".", ".", ".", ".", ".", ".", ".", ".", ".", ".", ".", ".", ".", ".", ".", "w"],
      ["w", "w", "w", "w", "w", "w", "w", "w", "w", "w", "w", "w", "w", "w", "w", "w", "w", "w", "w", "w", "w", "w"]
    ],
    "required_crystals": 7
  }