{
  "tiles": [
    ["w", "w", "w", "w", "w", "w", "w", "w", "w", "w", "w", "w", "w", "w", "w", ".", ".", "w", "w", "w"],
    ["w", "p", ".", ".", ".", "c", "w", ".", ".", "w", ".", "h", "h", "m", ".", ".", ".", "m", ".", "w"],
    ["w", ".", ".", ".", "w", "w", "w", ".", "m", "w", "c", "h", "h", ".", "m", ".", ".", ".", ".", "w"],
    ["w", ".", "w", "w", "w", "c", "h", ".", ".", "w", "w", "w", ".", ".", ".", ".", ".", ".", ".", "w"],
    ["w", ".", "w", ".", "w", "w", "w", ".", ".", "w", "w", "w", "w", "w", "od", "w", "w", "w", ".", "w"],
    ["w", ".", "w", ".", ".", ".", "or", ".", ".", ".", ".", "m", ".", "m", ".", ".", ".", "w", ".", "w"],
    ["w", ".", "w", ".", "w", ".", "w", ".", ".", ".", ".", ".", "m", ".", "m", ".", ".", "w", ".", "w"],
    ["w", ".", "w", ".", "w", ".", "w", ".", ".", ".", ".", ".", ".", "m", "w", ".", ".", "w", ".", "w"],
    ["w", ".", "w", ".", "w", ".", "w", ".", ".", ".", "w", "w", "w", "w", "c", "w", ".", "w", ".", "w"],
    ["w", ".", "w", ".", "w", ".", ".", "w", ".", ".", ".", ".", ".", ".", ".", "w", "h", "w", ".", "w"],
    ["w", ".", "w", ".", "w", ".", ".", "w", ".", "w", "w", "w", "w", ".", ".", "w", "c", "w", ".", "w"],
    ["w", ".", "w", ".", "w", ".", ".", ".", ".", ".", ".", ".", ".", ".", ".", "w", "h", "w", ".", "w"],
    ["w", ".", "w", ".", "w", ".", "m", ".", ".", ".", ".", ".", ".", ".", "w", "w", "c", "w", ".", "w"],
    ["w", ".", "w", ".", "w", ".", ".", "w", "w", "w", "w", ".", ".", "h", "w", "w", ".", "w", ".", "w"],
    ["w", ".", "w", ".", "w", "w", "w", "w", ".", "c", "w", ".", ".", "h", "x", "w", ".", "w", ".", "w"],
    ["w", ".", "w", ".", ".", ".", ".", ".", ".", ".", "w", "w", "w", "w", "w", "w", ".", "w", ".", "w"],
    ["w", ".", "w", ".", ".", ".", ".", ".", ".", ".", ".", ".", ".", ".", ".", ".", ".", "w", ".", "w"],
    ["w", ".", "w", "w", "w", "w", "w", "w", "w", "w", "w", "w", "w", "w", "w", "w", "w", "w", ".", "w"],
    ["w", ".", ".", ".", ".", ".", ".", ".", ".", ".", ".", ".", ".", ".", ".", ".", ".", ".", ".", "w"],
    ["w", "w", "w", "w", "w", "w", "w", "w", "w", "w", "w", "w", "w", "w", "w", "w", "w", "w", "w", "w"]
  ],
  "required_crystals": 7
}