{
  "tiles": [
    ["w", "w", "w", "w", "w", "w", "w", "w", "w", "w", "w", "w", "w", "w"],
    ["w", "p", ".", ".", "m", ".", "w", "w", "w", "w", ".", ".", ".", "w"],
    ["w", ".", ".", ".", ".", "w", ".", "w", "w", "w", ".", ".", ".", "w"],
    ["w", "c", ".", ".", ".", "c", "w", ".", ".", ".", ".", ".", "od", "w"],
    ["w", ".", "m", ".", "m", ".", ".", ".", ".", ".", ".", "w", "c", "w"],
    ["w", ".", ".", ".", ".", "x", "w", ".", ".", ".", ".", ".", "h", "w"],
    ["w", "w", "w", "w", "w", "w", "w", "w", "w", "w", "w", "w", "w", "w"]
  ],
  "required_crystals": 3
}