{
  "tiles": [
    ["w", "w", "w", "w", "w", "w", "w", "w", "w", "w", "w", "w", "w", "w", "w", "w", "w", "w", "w", "w"],
    ["w", ".", ".", ".", ".", ".", ".", ".", ".", ".", "w", "x", "w", ".", ".", ".", ".", "w", "w", "w"],
    ["w", ".", "w", "w", "w", ".", ".", ".", ".", ".", "or", ".", "w", ".", ".", ".", ".", ".", "w", "w"],
    ["w", ".", "w", "c", "h", ".", ".", ".", ".", ".", "w", "w", "w", ".", "m", ".", "m", ".", "w", "w"],
    ["w", ".", "w", "h", "w", "w", "w", ".", ".", ".", "w", "c", "w", ".", ".", "m", ".", ".", "w", "w"],
    ["w", ".", "w", ".", "w", "c", "h", ".", ".", ".", ".", "h", "w", ".", "m", ".", "m", ".", "w", "w"],
    ["w", ".", ".", ".", "w", "h", "w", "w", "w", ".", "w", "w", "w", ".", ".", ".", ".", ".", "w", "w"],
    ["w", ".", ".", ".", "w", ".", "w", "c", "w", ".", "w", ".", ".", ".", ".", ".", ".", ".", "w", "w"],
    ["w", ".", ".", ".", ".", ".", "w", "h", ".", ".", ".", ".", ".", ".", ".", ".", ".", ".", "w", "w"],
    ["w", ".", ".", ".", ".", ".", "w", ".", "w", ".", ".", ".", ".", ".", ".", ".", ".", ".", "w", "w"],
    ["w", ".", ".", ".", "m", ".", ".", ".", ".", ".", ".", ".", ".", ".", ".", ".", ".", ".", ".", "w"],
    ["w", ".", ".", ".", ".", "w", "w", "w", "w", ".", ".", ".", ".", ".", ".", ".", ".", ".", ".", "w"],
    ["w", ".", ".", ".", ".", ".", ".", ".", ".", ".", ".", ".", ".", ".", ".", ".", ".", ".", ".", "w"],
    ["w", "p", ".", ".", ".", ".", ".", ".", ".", ".", ".", ".", ".", ".", ".", ".", ".", ".", ".", "w"],
    ["w", "w", "w", "w", "w", "w", "w", "w", "w", "w", "w", "w", "w", "w", "w", "w", "w", "w", "w", "w"]
  ],
  "required_crystals": 4
}