{
    "tiles": [
      ["w", "w", "w", "w", "w", "w", "w", "w", "w", "w", "w", "w", "w", "w", "w", "w", "w", "w", "w", "w", "w", "w"],
      ["w", "p", ".", ".", "m", ".", ".", ".", ".", ".", ".", "w", "w", "w", "w", "w", "w", "w", ".", ".", ".", "w"],
      ["w", ".", "ol", ".", "or", ".", ".", ".", ".", ".", "w", ".", "w", "w", "w", "w", "w", "w", ".", ".", ".", "w"],
      ["w", "c", "ou", "h", "od", "c", "w", ".", ".", ".", "w", ".", ".", ".", ".", ".", ".", ".", ".", ".", "od", "w"],
      ["w", ".", "m", ".", "m", ".", ".", ".", ".", ".", "w", ".", ".", ".", ".", ".", ".", ".", ".", "w", "c", "w"],
      ["w", ".", ".", ".", ".", ".", "w", ".", ".", "w", ".", ".", ".", ".", ".", ".", ".", ".", ".", ".", ".", "w"],
      ["w", ".", ".", ".", ".", ".", ".", "w", ".", "w", ".", ".", ".", ".", ".", ".", ".", ".", ".", ".", ".", "w"],
      ["w", ".", ".", ".", ".", ".", ".", "w", ".", "w", ".", ".", ".", ".", ".", ".", ".", ".", ".", ".", ".", "w"],
      ["w", ".", ".", ".", ".", ".", ".", "w", ".", "w", ".", ".", ".", ".", ".", ".", ".", ".", ".", ".", ".", "w"],
      ["w", ".", ".", ".", ".", ".", ".", "w", ".", "w", ".", ".", ".", ".", ".", ".", ".", ".", ".", ".", ".", "w"],
      ["w", ".", ".", ".", ".", ".", ".", ".", ".", ".", ".", ".", ".", ".", ".", ".", ".", ".", ".", ".", ".", "w"],
      ["w", ".", ".", ".", ".", ".", ".", ".", ".", ".", ".", ".", ".", ".", ".", ".", ".", ".", ".", "h", ".", "w"],
      ["w", ".", ".", ".", ".", ".", ".", ".", ".", ".", ".", ".", ".", ".", ".", ".", ".", ".", "h", "x", "h", "w"],
      ["w", ".", ".", ".", ".", ".", ".", ".", ".", ".", ".", ".", ".", ".", ".", ".", ".", ".", ".", "h", ".", "w"],
      ["w", ".", ".", ".", ".", ".", ".", ".", ".", ".", ".", ".", ".", ".", ".", ".", ".", ".", ".", ".", ".", "w"],
      ["w", "w", "w", "w", "w", "w", "w", "w", "w", "w", "w", "w", "w", "w", "w", "w", "w", "w", "w", "w", "w", "w"]
    ],
    "required_crystals": 3
  }