{
  "tiles": [
    ["w", "w", "w", "w", "w", "w", "w", "w", "w", "w", "w", "w", "w", "w", "w", "w"],
    ["w", "p", "or", ".", ".", ".", ".", ".", ".", ".", ".", ".", ".", ".", ".", "w"],
    ["w", ".", "w", "m", "c", "m", "c", "m", "c", "m", "c", "m", "c", "m", ".", "w"],
    ["w", ".", "w", "c", "m", "w", "m", "c", "m", "c", "m", "c", "m", "c", "m", "w"],
    ["w", ".", "w", "m", "c", "m", "c", "m", "c", "m", "c", "m", "c", "m", ".", "w"],
    ["w", ".", "w", "c", "m", "c", "m", "c", "m", "c", "m", ".", "m", ".", "m", "w"],
    ["w", ".", "w", ".", ".", ".", ".", ".", ".", ".", ".", ".", ".", ".", ".", "w"],
    ["w", ".", "w", ".", ".", ".", ".", ".", ".", ".", ".", ".", ".", ".", ".", "w"],
    ["w", ".", "w", ".", ".", ".", ".", ".", ".", ".", ".", ".", ".", ".", ".", "w"],
    ["w", ".", "w", ".", ".", ".", ".", ".", ".", ".", ".", ".", ".", ".", ".", "w"],
    ["w", ".", "w", ".", ".", ".", ".", ".", ".", ".", ".", ".", ".", ".", ".", "w"],
    ["w", ".", "w", "h", "w", "h", "w", "h", "w", "h", "w", "h", "w", "h", "w", "w"],
    ["w", ".", "w", "c", "w", "c", "w", "c", "w", "c", "w", "c", "w", "c", ".", "w"],
    ["w", ".", "w", "h", "h", "h", "h", "h", "h", "h", "h", "h", "h", "h", "h", "w"],
    ["w", "c", "or", ".", ".", ".", ".", ".", ".", ".", ".", ".", ".", ".", "x", "w"],
    ["w", "w", "w", "w", "w", "w", "w", "w", "w", "w", "w", "w", "w", "w", "w", "w"]
  ],
  "required_crystals":26 
}