{
  "tiles": [
    ["w", "w", "w", "w", "w", "w", "w", "w", "w", "w", "w", "w", "w", "w", "w", "w"],
    ["w", "c", "w", "w", "w", "c", "w", ".", ".", ".", "w", "w", "w", "w", "w", "w"],
    ["w", ".", "w", ".", ".", ".", ".", ".", ".", ".", ".", "w", "w", "c", "w", "w"],
    ["w", ".", "w", ".", "m", "w", ".", ".", ".", ".", ".", ".", "w", "h", "w", "w"],
    ["w", ".", "w", ".", ".", "w", ".", ".", ".", ".", ".", ".", ".", ".", ".", "w"],
    ["w", ".", "w", "w", ".", "or", ".", ".", ".", ".", ".", ".", ".", ".", ".", "w"],
    ["w", ".", ".", "w", "w", "w", ".", ".", ".", ".", ".", ".", ".", ".", ".", "w"],
    ["w", ".", ".", ".", ".", "w", ".", "w", "h", "w", ".", ".", ".", ".", ".", "w"],
    ["w", ".", ".", ".", ".", "w", "p", "w", ".", "w", ".", ".", ".", ".", "d", "w"],
    ["w", "w", ".", ".", ".", "w", "w", "w", ".", "w", "w", ".", "m", "w", "w", "w"],
    ["w", "w", ".", ".", ".", ".", ".", ".", ".", ".", "w", "w", ".", ".", ".", "w"],
    ["w", "w", "w", ".", ".", ".", ".", ".", ".", ".", "w", "w", ".", ".", ".", "w"],
    ["w", "w", "w", "w", ".", ".", ".", ".", ".", ".", ".", "w", "w", "w", ".", "w"],
    ["w", "w", "w", "w", "w", ".", ".", ".", ".", ".", ".", ".", "w", "w", ".", "w"],
    ["w", "w", "w", "w", "w", "w", ".", ".", "x", ".", ".", ".", ".", ".", ".", "w"],
    ["w", "w", "w", "w", "w", "w", "w", "w", "w", "w", "w", "w", "w", "w", "w", "w"]
  ],
  "required_crystals": 3
}