{
  "tiles": [
    ["w", "w", "w", "w", "w", "w", "w", "w", "w", "w", "w", "w", "w", "w", "w", "w", "w", "w", "w", "w", "w", "w"],
    ["w", "d", "p", ".", "m", ".", ".", ".", "w", ".", ".", "w", "w", "w", "w", "w", "w", "w", ".", ".", ".", "w"],
    ["w", ".", "w", ".", ".", ".", ".", ".", "w", ".", "m", ".", "w", "w", "w", "w", "w", "w", ".", ".", ".", "w"],
    ["w", "c", ".", "m", ".", "c", "w", ".", "w", ".", ".", ".", ".", "h", "c", "w", ".", ".", ".", ".", "od", "w"],
    ["w", ".", "m", "c", "m", ".", ".", ".", "w", "w", "w", "w", ".", ".", "w", ".", ".", ".", ".", "w", "c", "w"],
    ["w", ".", ".", "m", ".", "x", ".", ".", ".", ".", ".", ".", ".", ".", ".", ".", ".", ".", ".", ".", "h", "w"],
    ["w", "w", "w", "w", "w", "w", "w", "w", "w", "w", "w", "w", "w", "w", "w", "w", "w", "w", "w", "w", "w", "w"]
  ],
  "required_crystals": 5
}