{
  "tiles": [
    ["w", "w", "w", "w", "w", "w", "w", "w", "w", "w", "w", "w", "w", "w"],
    ["w", "p", ".", ".", "m", ".", "w", "w", "w", "w", ".", ".", ".", "w"],
    ["w", ".", ".", ".", ".", "w", ".", "w", "w", "w", ".", ".", ".", "w"],
    ["w", "c", ".", ".", ".", "c", "w", ".", ".", ".", ".", "w", ".", "w"],
    ["w", ".", "m", ".", "m", ".", ".", ".", ".", ".", ".", "w", "c", "w"],
    ["w", ".", ".", ".", ".", "x", "w", ".", ".", ".", ".", ".", "d", "w"],
    ["w", "w", "w", "w", "w", "w", "w", "w", "w", "w", "w", "w", "w", "w"]
  ],
  "required_crystals": 3
}